id,plant_species,type,conspecific_pollen,pollen_total,heterospecific_pollen,year,day
22_Suc_B1_1,Succisa_pratensis,deposition_celkem,15,89,74,2022,12
22_Suc_B1_2,Succisa_pratensis,deposition_celkem,38,94,56,2022,12
22_Suc_B1_3,Succisa_pratensis,deposition_celkem,31,58,27,2022,12
22_Suc_B2_1,Succisa_pratensis,deposition_celkem,17,50,33,2022,12
22_Suc_B2_2,Succisa_pratensis,deposition_celkem,20,36,16,2022,12
22_Suc_B2_3,Succisa_pratensis,deposition_celkem,7,25,18,2022,12
22_Suc_B3_1,Succisa_pratensis,deposition_celkem,28,57,29,2022,12
22_Suc_B3_2,Succisa_pratensis,deposition_celkem,41,70,29,2022,12
22_Suc_B3_3,Succisa_pratensis,deposition_celkem,24,52,28,2022,12
22_Suc_B4_1,Succisa_pratensis,deposition_celkem,19,43,24,2022,12
22_Suc_B4_2,Succisa_pratensis,deposition_celkem,8,14,6,2022,12
22_Suc_B4_3,Succisa_pratensis,deposition_celkem,15,28,13,2022,12
22_Suc_B5_1,Succisa_pratensis,deposition_celkem,14,32,18,2022,12
22_Suc_B5_2,Succisa_pratensis,deposition_celkem,19,39,20,2022,12
22_Suc_B5_3,Succisa_pratensis,deposition_celkem,20,27,7,2022,12
22_Suc_B6_1,Succisa_pratensis,deposition_celkem,30,60,30,2022,12
22_Suc_B6_2,Succisa_pratensis,deposition_celkem,23,32,9,2022,12
22_Suc_B6_3,Succisa_pratensis,deposition_celkem,29,39,10,2022,12
22_Suc_B7_1,Succisa_pratensis,deposition_celkem,53,77,24,2022,12
22_Suc_B7_2,Succisa_pratensis,deposition_celkem,35,64,29,2022,12
22_Suc_B7_3,Succisa_pratensis,deposition_celkem,59,99,40,2022,12
22_Suc_B8_1,Succisa_pratensis,deposition_celkem,4,19,15,2022,12
22_Suc_B8_2,Succisa_pratensis,deposition_celkem,30,44,14,2022,12
22_Suc_B8_3,Succisa_pratensis,deposition_celkem,15,24,9,2022,12
22_Suc_B9_1,Succisa_pratensis,deposition_celkem,18,24,6,2022,12
22_Suc_B9_2,Succisa_pratensis,deposition_celkem,4,9,5,2022,12
22_Suc_B9_3,Succisa_pratensis,deposition_celkem,13,25,12,2022,12
22_Suc_B10_1,Succisa_pratensis,deposition_celkem,28,84,56,2022,12
22_Suc_B10_2,Succisa_pratensis,deposition_celkem,30,48,18,2022,12
22_Suc_B10_3,Succisa_pratensis,deposition_celkem,8,20,12,2022,12
22_Suc_B11_1,Succisa_pratensis,deposition_celkem,21,104,83,2022,12
22_Suc_B11_2,Succisa_pratensis,deposition_celkem,10,65,55,2022,12
22_Suc_B12_1,Succisa_pratensis,deposition_celkem,12,78,66,2022,12
22_Suc_B12_2,Succisa_pratensis,deposition_celkem,14,81,67,2022,12
22_Suc_B12_3,Succisa_pratensis,deposition_celkem,0,1,1,2022,12
22_Suc_B13_1,Succisa_pratensis,deposition_celkem,21,49,28,2022,12
22_Suc_B13_2,Succisa_pratensis,deposition_celkem,31,113,82,2022,12
22_Suc_B13_3,Succisa_pratensis,deposition_celkem,24,110,86,2022,12
22_Suc_B14_1,Succisa_pratensis,deposition_celkem,40,81,41,2022,12
22_Suc_B14_2,Succisa_pratensis,deposition_celkem,43,115,72,2022,12
22_Suc_B14_3,Succisa_pratensis,deposition_celkem,35,81,46,2022,12
22_Suc_B15_1,Succisa_pratensis,deposition_celkem,19,35,16,2022,12
22_Suc_B15_2,Succisa_pratensis,deposition_celkem,23,71,48,2022,12
22_Suc_B15_3,Succisa_pratensis,deposition_celkem,31,52,21,2022,12
22_Suc_B16_1,Succisa_pratensis,deposition_celkem,14,57,43,2022,12
22_Suc_B16_2,Succisa_pratensis,deposition_celkem,7,37,30,2022,12
22_Suc_B16_3,Succisa_pratensis,deposition_celkem,10,70,60,2022,12
22_Suc_B17_1,Succisa_pratensis,deposition_celkem,7,54,47,2022,12
22_Suc_B17_2,Succisa_pratensis,deposition_celkem,0,0,0,2022,12
22_Suc_B17_3,Succisa_pratensis,deposition_celkem,0,0,0,2022,12
22_Suc_B18_1,Succisa_pratensis,deposition_celkem,46,119,73,2022,12
22_Suc_B18_2,Succisa_pratensis,deposition_celkem,39,96,57,2022,12
22_Suc_B18_3,Succisa_pratensis,deposition_celkem,29,72,43,2022,12
22_Suc_B19_1,Succisa_pratensis,deposition_celkem,29,56,27,2022,12
22_Suc_B19_2,Succisa_pratensis,deposition_celkem,38,99,61,2022,12
22_Suc_B19_3,Succisa_pratensis,deposition_celkem,32,93,61,2022,12
22_Suc_B20_1,Succisa_pratensis,deposition_celkem,27,106,79,2022,12
22_Suc_B20_2,Succisa_pratensis,deposition_celkem,35,134,99,2022,12
22_Suc_B20_3,Succisa_pratensis,deposition_celkem,26,90,64,2022,12
22_Suc_B22_1,Succisa_pratensis,deposition_celkem,0,13,13,2022,12
22_Suc_B22_2,Succisa_pratensis,deposition_celkem,1,1,0,2022,12
22_Suc_B22_3,Succisa_pratensis,deposition_celkem,0,0,0,2022,12
22_Suc_B23_1,Succisa_pratensis,deposition_celkem,37,105,68,2022,12
22_Suc_B23_2,Succisa_pratensis,deposition_celkem,19,44,25,2022,12
22_Suc_B23_3,Succisa_pratensis,deposition_celkem,34,128,94,2022,12
22_Suc_B24_1,Succisa_pratensis,deposition_celkem,24,52,28,2022,12
22_Suc_B24_2,Succisa_pratensis,deposition_celkem,29,68,39,2022,12
22_Suc_B24_3,Succisa_pratensis,deposition_celkem,30,80,50,2022,12
22_Suc_B25_1,Succisa_pratensis,deposition_celkem,22,62,40,2022,12
22_Suc_B25_2,Succisa_pratensis,deposition_celkem,25,86,61,2022,12
22_Suc_B25_3,Succisa_pratensis,deposition_celkem,29,103,74,2022,12
22_Suc_B26_1,Succisa_pratensis,deposition_celkem,20,64,44,2022,12
22_Suc_B26_3,Succisa_pratensis,deposition_celkem,26,94,68,2022,12
22_Suc_B27_1,Succisa_pratensis,deposition_celkem,7,25,18,2022,12
22_Suc_B27_3,Succisa_pratensis,deposition_celkem,4,17,13,2022,12
22_Suc_B28_1,Succisa_pratensis,deposition_celkem,0,11,11,2022,12
22_Suc_B28_2,Succisa_pratensis,deposition_celkem,0,0,0,2022,12
22_Suc_B28_3,Succisa_pratensis,deposition_celkem,18,74,56,2022,12
22_Suc_B29_1,Succisa_pratensis,deposition_celkem,0,0,0,2022,12
22_Suc_B29_2,Succisa_pratensis,deposition_celkem,1,2,1,2022,12
22_Suc_B29_3,Succisa_pratensis,deposition_celkem,0,0,0,2022,12
22_Suc_B30_1,Succisa_pratensis,deposition_celkem,19,81,62,2022,12
22_Suc_B30_2,Succisa_pratensis,deposition_celkem,1,4,3,2022,12
22_Suc_B30_3,Succisa_pratensis,deposition_celkem,21,71,50,2022,12
23_Suc_B1_1,Succisa_pratensis,deposition_celkem,0,2,2,2023,12
23_Suc_B1_2,Succisa_pratensis,deposition_celkem,0,6,6,2023,12
23_Suc_B1_3,Succisa_pratensis,deposition_celkem,2,38,36,2023,12
23_Suc_B2_1,Succisa_pratensis,deposition_celkem,0,0,0,2023,12
23_Suc_B2_2,Succisa_pratensis,deposition_celkem,6,58,52,2023,12
23_Suc_B2_3,Succisa_pratensis,deposition_celkem,48,54,6,2023,12
23_Suc_B3_1,Succisa_pratensis,deposition_celkem,44,143,99,2023,12
23_Suc_B3_2,Succisa_pratensis,deposition_celkem,32,166,134,2023,12
23_Suc_B3_3,Succisa_pratensis,deposition_celkem,47,144,97,2023,12
23_Suc_B4_1,Succisa_pratensis,deposition_celkem,22,152,130,2023,12
23_Suc_B4_2,Succisa_pratensis,deposition_celkem,27,157,130,2023,12
23_Suc_B4_3,Succisa_pratensis,deposition_celkem,45,151,106,2023,12
23_Suc_B5_1,Succisa_pratensis,deposition_celkem,0,0,0,2023,12
23_Suc_B5_2,Succisa_pratensis,deposition_celkem,0,0,0,2023,12
23_Suc_B5_3,Succisa_pratensis,deposition_celkem,0,0,0,2023,12
23_Suc_B6_1,Succisa_pratensis,deposition_celkem,12,58,46,2023,12
23_Suc_B6_2,Succisa_pratensis,deposition_celkem,21,103,82,2023,12
23_Suc_B6_3,Succisa_pratensis,deposition_celkem,19,59,40,2023,12
23_Suc_B7_1,Succisa_pratensis,deposition_celkem,18,227,209,2023,12
23_Suc_B7_2,Succisa_pratensis,deposition_celkem,12,171,159,2023,12
23_Suc_B7_3,Succisa_pratensis,deposition_celkem,11,50,39,2023,12
23_Suc_B8_1,Succisa_pratensis,deposition_celkem,19,84,65,2023,12
23_Suc_B8_2,Succisa_pratensis,deposition_celkem,22,89,67,2023,12
23_Suc_B8_3,Succisa_pratensis,deposition_celkem,16,106,90,2023,12
23_Suc_B9_1,Succisa_pratensis,deposition_celkem,11,42,31,2023,12
23_Suc_B9_2,Succisa_pratensis,deposition_celkem,25,53,28,2023,12
23_Suc_B9_3,Succisa_pratensis,deposition_celkem,21,95,74,2023,12
23_Suc_B10_1,Succisa_pratensis,deposition_celkem,24,145,121,2023,12
23_Suc_B10_2,Succisa_pratensis,deposition_celkem,28,186,158,2023,12
23_Suc_B10_3,Succisa_pratensis,deposition_celkem,30,83,53,2023,12
23_Suc_B11_1,Succisa_pratensis,deposition_celkem,19,149,130,2023,12
23_Suc_B11_2,Succisa_pratensis,deposition_celkem,37,205,168,2023,12
23_Suc_B11_3,Succisa_pratensis,deposition_celkem,23,197,174,2023,12
23_Suc_B12_1,Succisa_pratensis,deposition_celkem,11,50,39,2023,12
23_Suc_B12_2,Succisa_pratensis,deposition_celkem,1,25,24,2023,12
23_Suc_B12_3,Succisa_pratensis,deposition_celkem,2,13,11,2023,12
23_Suc_B13_1,Succisa_pratensis,deposition_celkem,1,1,0,2023,12
23_Suc_B13_2,Succisa_pratensis,deposition_celkem,0,0,0,2023,12
23_Suc_B13_3,Succisa_pratensis,deposition_celkem,21,42,21,2023,12
23_Suc_B14_1,Succisa_pratensis,deposition_celkem,53,68,15,2023,12
23_Suc_B14_2,Succisa_pratensis,deposition_celkem,18,40,22,2023,12
23_Suc_B14_3,Succisa_pratensis,deposition_celkem,40,59,19,2023,12
23_Suc_B15_1,Succisa_pratensis,deposition_celkem,3,18,15,2023,12
23_Suc_B15_2,Succisa_pratensis,deposition_celkem,0,1,1,2023,12
23_Suc_B15_3,Succisa_pratensis,deposition_celkem,0,1,1,2023,12
23_Suc_B16_1,Succisa_pratensis,deposition_celkem,17,39,22,2023,12
23_Suc_B16_2,Succisa_pratensis,deposition_celkem,32,55,23,2023,12
23_Suc_B16_3,Succisa_pratensis,deposition_celkem,19,43,24,2023,12
23_Suc_B17_1,Succisa_pratensis,deposition_celkem,37,66,29,2023,12
23_Suc_B17_2,Succisa_pratensis,deposition_celkem,33,76,43,2023,12
23_Suc_B17_3,Succisa_pratensis,deposition_celkem,11,23,12,2023,12
23_Suc_B18_1,Succisa_pratensis,deposition_celkem,18,40,22,2023,12
23_Suc_B18_2,Succisa_pratensis,deposition_celkem,17,59,42,2023,12
23_Suc_B18_3,Succisa_pratensis,deposition_celkem,19,38,19,2023,12
23_Suc_B19_1,Succisa_pratensis,deposition_celkem,10,10,0,2023,12
23_Suc_B19_2,Succisa_pratensis,deposition_celkem,0,0,0,2023,12
23_Suc_B19_3,Succisa_pratensis,deposition_celkem,0,1,1,2023,12
23_Suc_B20_1,Succisa_pratensis,deposition_celkem,43,100,57,2023,12
23_Suc_B20_2,Succisa_pratensis,deposition_celkem,24,91,67,2023,12
23_Suc_B20_3,Succisa_pratensis,deposition_celkem,21,50,29,2023,12
23_Suc_B21_1,Succisa_pratensis,deposition_celkem,14,43,29,2023,12
23_Suc_B21_2,Succisa_pratensis,deposition_celkem,47,77,30,2023,12
23_Suc_B21_3,Succisa_pratensis,deposition_celkem,29,70,41,2023,12
23_Suc_B22_1,Succisa_pratensis,deposition_celkem,11,35,24,2023,12
23_Suc_B22_2,Succisa_pratensis,deposition_celkem,9,136,127,2023,12
23_Suc_B22_3,Succisa_pratensis,deposition_celkem,5,22,17,2023,12
23_Suc_B23_1,Succisa_pratensis,deposition_celkem,32,70,38,2023,12
23_Suc_B23_2,Succisa_pratensis,deposition_celkem,19,47,28,2023,12
23_Suc_B23_3,Succisa_pratensis,deposition_celkem,NA,NA,NA,2023,12
23_Suc_B24_1,Succisa_pratensis,deposition_celkem,24,83,59,2023,12
23_Suc_B24_2,Succisa_pratensis,deposition_celkem,57,116,59,2023,12
23_Suc_B24_3,Succisa_pratensis,deposition_celkem,45,104,59,2023,12
23_Suc_B25_1,Succisa_pratensis,deposition_celkem,26,72,46,2023,12
23_Suc_B25_2,Succisa_pratensis,deposition_celkem,43,89,46,2023,12
23_Suc_B25_3,Succisa_pratensis,deposition_celkem,52,129,77,2023,12
23_Suc_B26_1,Succisa_pratensis,deposition_celkem,38,70,32,2023,12
23_Suc_B26_2,Succisa_pratensis,deposition_celkem,25,56,31,2023,12
23_Suc_B26_3,Succisa_pratensis,deposition_celkem,32,65,33,2023,12
23_Suc_B27_1,Succisa_pratensis,deposition_celkem,18,52,34,2023,12
23_Suc_B27_2,Succisa_pratensis,deposition_celkem,22,52,30,2023,12
23_Suc_B27_3,Succisa_pratensis,deposition_celkem,19,38,19,2023,12
23_Suc_B28_1,Succisa_pratensis,deposition_celkem,2,18,16,2023,12
23_Suc_B28_2,Succisa_pratensis,deposition_celkem,20,81,61,2023,12
23_Suc_B28_3,Succisa_pratensis,deposition_celkem,7,80,73,2023,12
23_Suc_B29_1,Succisa_pratensis,deposition_celkem,2,8,6,2023,12
23_Suc_B29_2,Succisa_pratensis,deposition_celkem,17,46,29,2023,12
23_Suc_B29_3,Succisa_pratensis,deposition_celkem,26,120,94,2023,12
23_Suc_B30_1,Succisa_pratensis,deposition_celkem,45,181,136,2023,12
23_Suc_B30_2,Succisa_pratensis,deposition_celkem,20,85,65,2023,12
23_Suc_B30_3,Succisa_pratensis,deposition_celkem,29,90,61,2023,12
24_11_8_Suc_B1_1,Succisa_pratensis,deposition_celkem,NA,NA,NA,2024,11
24_11_8_Suc_B1_2,Succisa_pratensis,deposition_celkem,44,83,39,2024,11
24_11_8_Suc_B1_3,Succisa_pratensis,deposition_celkem,58,65,7,2024,11
24_11_8_Suc_B2_1,Succisa_pratensis,deposition_celkem,37,43,6,2024,11
24_11_8_Suc_B2_2,Succisa_pratensis,deposition_celkem,25,34,9,2024,11
24_11_8_Suc_B2_3,Succisa_pratensis,deposition_celkem,31,41,10,2024,11
24_11_8_Suc_B3_1,Succisa_pratensis,deposition_celkem,15,27,12,2024,11
24_11_8_Suc_B3_2,Succisa_pratensis,deposition_celkem,31,31,0,2024,11
24_11_8_Suc_B3_3,Succisa_pratensis,deposition_celkem,77,87,10,2024,11
24_11_8_Suc_B4_1,Succisa_pratensis,deposition_celkem,12,18,6,2024,11
24_11_8_Suc_B4_2,Succisa_pratensis,deposition_celkem,22,41,19,2024,11
24_11_8_Suc_B4_3,Succisa_pratensis,deposition_celkem,21,28,7,2024,11
24_11_8_Suc_B5_1,Succisa_pratensis,deposition_celkem,24,27,3,2024,11
24_11_8_Suc_B5_2,Succisa_pratensis,deposition_celkem,12,21,9,2024,11
24_11_8_Suc_B5_3,Succisa_pratensis,deposition_celkem,22,30,8,2024,11
24_11_8_Suc_B6_1,Succisa_pratensis,deposition_celkem,51,58,7,2024,11
24_11_8_Suc_B6_2,Succisa_pratensis,deposition_celkem,49,51,2,2024,11
24_11_8_Suc_B6_3,Succisa_pratensis,deposition_celkem,45,50,5,2024,11
24_11_8_Suc_B7_1,Succisa_pratensis,deposition_celkem,8,15,7,2024,11
24_11_8_Suc_B7_2,Succisa_pratensis,deposition_celkem,36,40,4,2024,11
24_11_8_Suc_B7_3,Succisa_pratensis,deposition_celkem,66,94,28,2024,11
24_11_8_Suc_B8_1,Succisa_pratensis,deposition_celkem,54,105,51,2024,11
24_11_8_Suc_B8_2,Succisa_pratensis,deposition_celkem,36,70,34,2024,11
24_11_8_Suc_B8_3,Succisa_pratensis,deposition_celkem,31,39,8,2024,11
24_11_8_Suc_B9_1,Succisa_pratensis,deposition_celkem,20,44,24,2024,11
24_11_8_Suc_B9_2,Succisa_pratensis,deposition_celkem,40,44,4,2024,11
24_11_8_Suc_B9_3,Succisa_pratensis,deposition_celkem,1,4,3,2024,11
24_11_8_Suc_B10_1,Succisa_pratensis,deposition_celkem,31,52,21,2024,11
24_11_8_Suc_B10_2,Succisa_pratensis,deposition_celkem,27,33,6,2024,11
24_11_8_Suc_B10_3,Succisa_pratensis,deposition_celkem,12,14,2,2024,11
24_11_8_Suc_B11_1,Succisa_pratensis,deposition_celkem,19,24,5,2024,11
24_11_8_Suc_B11_2,Succisa_pratensis,deposition_celkem,30,32,2,2024,11
24_11_8_Suc_B11_3,Succisa_pratensis,deposition_celkem,11,11,0,2024,11
24_11_8_Suc_B12_1,Succisa_pratensis,deposition_celkem,22,37,15,2024,11
24_11_8_Suc_B12_2,Succisa_pratensis,deposition_celkem,30,37,7,2024,11
24_11_8_Suc_B12_3,Succisa_pratensis,deposition_celkem,31,43,12,2024,11
24_11_8_Suc_B13_1,Succisa_pratensis,deposition_celkem,62,69,7,2024,11
24_11_8_Suc_B13_2,Succisa_pratensis,deposition_celkem,43,48,5,2024,11
24_11_8_Suc_B13_3,Succisa_pratensis,deposition_celkem,34,37,3,2024,11
24_11_8_Suc_B14_1,Succisa_pratensis,deposition_celkem,39,52,13,2024,11
24_11_8_Suc_B14_2,Succisa_pratensis,deposition_celkem,28,30,2,2024,11
24_11_8_Suc_B14_3,Succisa_pratensis,deposition_celkem,26,48,22,2024,11
24_11_8_Suc_B15_1,Succisa_pratensis,deposition_celkem,1,2,1,2024,11
24_11_8_Suc_B15_2,Succisa_pratensis,deposition_celkem,18,36,18,2024,11
24_11_8_Suc_B15_3,Succisa_pratensis,deposition_celkem,7,9,2,2024,11
24_11_8_Suc_B16_1,Succisa_pratensis,deposition_celkem,33,45,12,2024,11
24_11_8_Suc_B16_2,Succisa_pratensis,deposition_celkem,30,40,10,2024,11
24_11_8_Suc_B16_3,Succisa_pratensis,deposition_celkem,30,46,16,2024,11
24_11_8_Suc_B17_1,Succisa_pratensis,deposition_celkem,45,49,4,2024,11
24_11_8_Suc_B17_2,Succisa_pratensis,deposition_celkem,28,29,1,2024,11
24_11_8_Suc_B17_3,Succisa_pratensis,deposition_celkem,40,53,13,2024,11
24_11_8_Suc_B18_1,Succisa_pratensis,deposition_celkem,20,22,2,2024,11
24_11_8_Suc_B18_2,Succisa_pratensis,deposition_celkem,56,63,7,2024,11
24_11_8_Suc_B18_3,Succisa_pratensis,deposition_celkem,43,50,7,2024,11
24_11_8_Suc_B19_1,Succisa_pratensis,deposition_celkem,82,84,2,2024,11
24_11_8_Suc_B19_2,Succisa_pratensis,deposition_celkem,81,83,2,2024,11
24_11_8_Suc_B19_3,Succisa_pratensis,deposition_celkem,55,56,1,2024,11
24_11_8_Suc_B20_1,Succisa_pratensis,deposition_celkem,8,19,11,2024,11
24_11_8_Suc_B20_2,Succisa_pratensis,deposition_celkem,18,22,4,2024,11
24_11_8_Suc_B20_3,Succisa_pratensis,deposition_celkem,11,13,2,2024,11
24_11_8_Suc_B21_1,Succisa_pratensis,deposition_celkem,21,25,4,2024,11
24_11_8_Suc_B21_2,Succisa_pratensis,deposition_celkem,21,28,7,2024,11
24_11_8_Suc_B21_3,Succisa_pratensis,deposition_celkem,26,27,1,2024,11
24_11_8_Suc_B22_1,Succisa_pratensis,deposition_celkem,16,25,9,2024,11
24_11_8_Suc_B22_2,Succisa_pratensis,deposition_celkem,29,34,5,2024,11
24_11_8_Suc_B22_3,Succisa_pratensis,deposition_celkem,13,16,3,2024,11
24_11_8_Suc_B23_1,Succisa_pratensis,deposition_celkem,10,11,1,2024,11
24_11_8_Suc_B23_2,Succisa_pratensis,deposition_celkem,23,27,4,2024,11
24_11_8_Suc_B23_3,Succisa_pratensis,deposition_celkem,15,16,1,2024,11
24_11_8_Suc_B24_1,Succisa_pratensis,deposition_celkem,51,65,14,2024,11
24_11_8_Suc_B24_2,Succisa_pratensis,deposition_celkem,54,73,19,2024,11
24_11_8_Suc_B24_3,Succisa_pratensis,deposition_celkem,51,63,12,2024,11
24_11_8_Suc_B25_1,Succisa_pratensis,deposition_celkem,55,60,5,2024,11
24_11_8_Suc_B25_2,Succisa_pratensis,deposition_celkem,39,44,5,2024,11
24_11_8_Suc_B25_3,Succisa_pratensis,deposition_celkem,22,26,4,2024,11
24_11_8_Suc_B26_1,Succisa_pratensis,deposition_celkem,78,84,6,2024,11
24_11_8_Suc_B26_2,Succisa_pratensis,deposition_celkem,57,58,1,2024,11
24_11_8_Suc_B26_3,Succisa_pratensis,deposition_celkem,45,51,6,2024,11
24_11_8_Suc_B27_1,Succisa_pratensis,deposition_celkem,37,56,19,2024,11
24_11_8_Suc_B27_2,Succisa_pratensis,deposition_celkem,51,67,16,2024,11
24_11_8_Suc_B27_3,Succisa_pratensis,deposition_celkem,29,41,12,2024,11
24_11_8_Suc_B28_1,Succisa_pratensis,deposition_celkem,11,14,3,2024,11
24_11_8_Suc_B28_2,Succisa_pratensis,deposition_celkem,6,37,31,2024,11
24_11_8_Suc_B28_3,Succisa_pratensis,deposition_celkem,13,13,0,2024,11
24_11_8_Suc_B29_1,Succisa_pratensis,deposition_celkem,84,91,7,2024,11
24_11_8_Suc_B29_2,Succisa_pratensis,deposition_celkem,NA,NA,NA,2024,11
24_11_8_Suc_B29_3,Succisa_pratensis,deposition_celkem,48,52,4,2024,11
24_11_8_Suc_B30_1,Succisa_pratensis,deposition_celkem,57,64,7,2024,11
24_11_8_Suc_B30_2,Succisa_pratensis,deposition_celkem,37,45,8,2024,11
24_11_8_Suc_B30_3,Succisa_pratensis,deposition_celkem,53,66,13,2024,11
24_12_8_Suc_B1_1,Succisa_pratensis,deposition_celkem,40,42,2,2024,12
24_12_8_Suc_B1_2,Succisa_pratensis,deposition_celkem,38,52,14,2024,12
24_12_8_Suc_B1_3,Succisa_pratensis,deposition_celkem,68,68,0,2024,12
24_12_8_Suc_B2_1,Succisa_pratensis,deposition_celkem,30,40,10,2024,12
24_12_8_Suc_B2_2,Succisa_pratensis,deposition_celkem,22,28,6,2024,12
24_12_8_Suc_B2_3,Succisa_pratensis,deposition_celkem,NA,NA,NA,2024,12
24_12_8_Suc_B3_1,Succisa_pratensis,deposition_celkem,40,50,10,2024,12
24_12_8_Suc_B3_2,Succisa_pratensis,deposition_celkem,33,40,7,2024,12
24_12_8_Suc_B3_3,Succisa_pratensis,deposition_celkem,49,49,0,2024,12
24_12_8_Suc_B4_1,Succisa_pratensis,deposition_celkem,12,33,21,2024,12
24_12_8_Suc_B4_2,Succisa_pratensis,deposition_celkem,37,43,6,2024,12
24_12_8_Suc_B4_3,Succisa_pratensis,deposition_celkem,27,29,2,2024,12
24_12_8_Suc_B5_1,Succisa_pratensis,deposition_celkem,49,55,6,2024,12
24_12_8_Suc_B5_2,Succisa_pratensis,deposition_celkem,43,43,0,2024,12
24_12_8_Suc_B5_3,Succisa_pratensis,deposition_celkem,55,60,5,2024,12
24_12_8_Suc_B6_1,Succisa_pratensis,deposition_celkem,26,32,6,2024,12
24_12_8_Suc_B6_2,Succisa_pratensis,deposition_celkem,15,20,5,2024,12
24_12_8_Suc_B6_3,Succisa_pratensis,deposition_celkem,1,1,0,2024,12
24_12_8_Suc_B7_1,Succisa_pratensis,deposition_celkem,6,13,7,2024,12
24_12_8_Suc_B7_2,Succisa_pratensis,deposition_celkem,16,16,0,2024,12
24_12_8_Suc_B7_3,Succisa_pratensis,deposition_celkem,9,11,2,2024,12
24_12_8_Suc_B8_1,Succisa_pratensis,deposition_celkem,6,9,3,2024,12
24_12_8_Suc_B8_2,Succisa_pratensis,deposition_celkem,29,42,13,2024,12
24_12_8_Suc_B8_3,Succisa_pratensis,deposition_celkem,14,21,7,2024,12
24_12_8_Suc_B9_1,Succisa_pratensis,deposition_celkem,57,61,4,2024,12
24_12_8_Suc_B9_2,Succisa_pratensis,deposition_celkem,40,40,0,2024,12
24_12_8_Suc_B9_3,Succisa_pratensis,deposition_celkem,24,26,2,2024,12
24_12_8_Suc_B10_1,Succisa_pratensis,deposition_celkem,41,43,2,2024,12
24_12_8_Suc_B10_2,Succisa_pratensis,deposition_celkem,47,50,3,2024,12
24_12_8_Suc_B10_3,Succisa_pratensis,deposition_celkem,52,55,3,2024,12
24_12_8_Suc_B11_1,Succisa_pratensis,deposition_celkem,8,12,4,2024,12
24_12_8_Suc_B11_2,Succisa_pratensis,deposition_celkem,19,21,2,2024,12
24_12_8_Suc_B11_3,Succisa_pratensis,deposition_celkem,22,31,9,2024,12
24_12_8_Suc_B12_1,Succisa_pratensis,deposition_celkem,44,54,10,2024,12
24_12_8_Suc_B12_2,Succisa_pratensis,deposition_celkem,47,57,10,2024,12
24_12_8_Suc_B12_3,Succisa_pratensis,deposition_celkem,52,57,5,2024,12
24_12_8_Suc_B13_1,Succisa_pratensis,deposition_celkem,63,73,10,2024,12
24_12_8_Suc_B13_2,Succisa_pratensis,deposition_celkem,31,37,6,2024,12
24_12_8_Suc_B13_3,Succisa_pratensis,deposition_celkem,52,73,21,2024,12
24_12_8_Suc_B14_1,Succisa_pratensis,deposition_celkem,66,101,35,2024,12
24_12_8_Suc_B14_2,Succisa_pratensis,deposition_celkem,48,71,23,2024,12
24_12_8_Suc_B14_3,Succisa_pratensis,deposition_celkem,61,85,24,2024,12
24_12_8_Suc_B15_1,Succisa_pratensis,deposition_celkem,35,37,2,2024,12
24_12_8_Suc_B15_2,Succisa_pratensis,deposition_celkem,37,38,1,2024,12
24_12_8_Suc_B15_3,Succisa_pratensis,deposition_celkem,16,17,1,2024,12
24_12_8_Suc_B16_1,Succisa_pratensis,deposition_celkem,11,11,0,2024,12
24_12_8_Suc_B16_2,Succisa_pratensis,deposition_celkem,10,16,6,2024,12
24_12_8_Suc_B16_3,Succisa_pratensis,deposition_celkem,2,2,0,2024,12
24_12_8_Suc_B17_1,Succisa_pratensis,deposition_celkem,44,56,12,2024,12
24_12_8_Suc_B17_2,Succisa_pratensis,deposition_celkem,33,44,11,2024,12
24_12_8_Suc_B17_3,Succisa_pratensis,deposition_celkem,29,32,3,2024,12
24_12_8_Suc_B18_1,Succisa_pratensis,deposition_celkem,0,0,0,2024,12
24_12_8_Suc_B18_2,Succisa_pratensis,deposition_celkem,24,33,9,2024,12
24_12_8_Suc_B18_3,Succisa_pratensis,deposition_celkem,1,1,0,2024,12
24_12_8_Suc_B19_1,Succisa_pratensis,deposition_celkem,65,75,10,2024,12
24_12_8_Suc_B19_2,Succisa_pratensis,deposition_celkem,52,97,45,2024,12
24_12_8_Suc_B19_3,Succisa_pratensis,deposition_celkem,61,85,24,2024,12
24_12_8_Suc_B20_1,Succisa_pratensis,deposition_celkem,33,44,11,2024,12
24_12_8_Suc_B20_2,Succisa_pratensis,deposition_celkem,37,43,6,2024,12
24_12_8_Suc_B20_3,Succisa_pratensis,deposition_celkem,24,37,13,2024,12
24_12_8_Suc_B21_1,Succisa_pratensis,deposition_celkem,0,1,1,2024,12
24_12_8_Suc_B21_2,Succisa_pratensis,deposition_celkem,10,13,3,2024,12
24_12_8_Suc_B21_3,Succisa_pratensis,deposition_celkem,2,2,0,2024,12
24_12_8_Suc_B22_1,Succisa_pratensis,deposition_celkem,NA,NA,NA,2024,12
24_12_8_Suc_B22_2,Succisa_pratensis,deposition_celkem,11,18,7,2024,12
24_12_8_Suc_B22_3,Succisa_pratensis,deposition_celkem,10,19,9,2024,12
24_12_8_Suc_B23_1,Succisa_pratensis,deposition_celkem,4,4,0,2024,12
24_12_8_Suc_B23_2,Succisa_pratensis,deposition_celkem,24,27,3,2024,12
24_12_8_Suc_B23_3,Succisa_pratensis,deposition_celkem,17,18,1,2024,12
24_12_8_Suc_B24_1,Succisa_pratensis,deposition_celkem,51,53,2,2024,12
24_12_8_Suc_B24_2,Succisa_pratensis,deposition_celkem,48,50,2,2024,12
24_12_8_Suc_B24_3,Succisa_pratensis,deposition_celkem,36,38,2,2024,12
24_12_8_Suc_B25_1,Succisa_pratensis,deposition_celkem,29,51,22,2024,12
24_12_8_Suc_B25_2,Succisa_pratensis,deposition_celkem,27,40,13,2024,12
24_12_8_Suc_B25_3,Succisa_pratensis,deposition_celkem,13,30,17,2024,12
24_12_8_Suc_B26_1,Succisa_pratensis,deposition_celkem,0,0,0,2024,12
24_12_8_Suc_B26_2,Succisa_pratensis,deposition_celkem,0,0,0,2024,12
24_12_8_Suc_B26_3,Succisa_pratensis,deposition_celkem,0,0,0,2024,12
24_12_8_Suc_B27_1,Succisa_pratensis,deposition_celkem,51,57,6,2024,12
24_12_8_Suc_B27_2,Succisa_pratensis,deposition_celkem,27,49,22,2024,12
24_12_8_Suc_B27_3,Succisa_pratensis,deposition_celkem,27,57,30,2024,12
24_12_8_Suc_B28_1,Succisa_pratensis,deposition_celkem,1,5,4,2024,12
24_12_8_Suc_B28_2,Succisa_pratensis,deposition_celkem,0,0,0,2024,12
24_12_8_Suc_B28_3,Succisa_pratensis,deposition_celkem,0,0,0,2024,12
24_12_8_Suc_B29_1,Succisa_pratensis,deposition_celkem,3,5,2,2024,12
24_12_8_Suc_B29_2,Succisa_pratensis,deposition_celkem,15,23,8,2024,12
24_12_8_Suc_B29_3,Succisa_pratensis,deposition_celkem,1,1,0,2024,12
24_12_8_Suc_B30_1,Succisa_pratensis,deposition_celkem,21,26,5,2024,12
24_12_8_Suc_B30_2,Succisa_pratensis,deposition_celkem,60,64,4,2024,12
24_12_8_Suc_B30_3,Succisa_pratensis,deposition_celkem,17,30,13,2024,12
24_13_8_Suc_B1_1,Succisa_pratensis,deposition_celkem,32,39,7,2024,13
24_13_8_Suc_B1_2,Succisa_pratensis,deposition_celkem,66,68,2,2024,13
24_13_8_Suc_B1_3,Succisa_pratensis,deposition_celkem,28,29,1,2024,13
24_13_8_Suc_B2_1,Succisa_pratensis,deposition_celkem,61,94,33,2024,13
24_13_8_Suc_B2_2,Succisa_pratensis,deposition_celkem,33,67,34,2024,13
24_13_8_Suc_B2_3,Succisa_pratensis,deposition_celkem,12,44,32,2024,13
24_13_8_Suc_B3_1,Succisa_pratensis,deposition_celkem,31,37,6,2024,13
24_13_8_Suc_B3_2,Succisa_pratensis,deposition_celkem,63,64,1,2024,13
24_13_8_Suc_B3_3,Succisa_pratensis,deposition_celkem,NA,NA,NA,2024,13
24_13_8_Suc_B4_1,Succisa_pratensis,deposition_celkem,1,1,0,2024,13
24_13_8_Suc_B4_2,Succisa_pratensis,deposition_celkem,0,0,0,2024,13
24_13_8_Suc_B4_3,Succisa_pratensis,deposition_celkem,47,87,40,2024,13
24_13_8_Suc_B5_1,Succisa_pratensis,deposition_celkem,22,24,2,2024,13
24_13_8_Suc_B5_2,Succisa_pratensis,deposition_celkem,15,18,3,2024,13
24_13_8_Suc_B5_3,Succisa_pratensis,deposition_celkem,13,19,6,2024,13
24_13_8_Suc_B6_1,Succisa_pratensis,deposition_celkem,51,54,3,2024,13
24_13_8_Suc_B6_2,Succisa_pratensis,deposition_celkem,56,58,2,2024,13
24_13_8_Suc_B6_3,Succisa_pratensis,deposition_celkem,54,56,2,2024,13
24_13_8_Suc_B7_1,Succisa_pratensis,deposition_celkem,6,6,0,2024,13
24_13_8_Suc_B7_2,Succisa_pratensis,deposition_celkem,35,67,32,2024,13
24_13_8_Suc_B7_3,Succisa_pratensis,deposition_celkem,12,50,38,2024,13
24_13_8_Suc_B8_1,Succisa_pratensis,deposition_celkem,2,8,6,2024,13
24_13_8_Suc_B8_2,Succisa_pratensis,deposition_celkem,40,42,2,2024,13
24_13_8_Suc_B8_3,Succisa_pratensis,deposition_celkem,23,27,4,2024,13
24_13_8_Suc_B9_1,Succisa_pratensis,deposition_celkem,37,61,24,2024,13
24_13_8_Suc_B9_2,Succisa_pratensis,deposition_celkem,59,88,29,2024,13
24_13_8_Suc_B9_3,Succisa_pratensis,deposition_celkem,26,66,40,2024,13
24_13_8_Suc_B10_1,Succisa_pratensis,deposition_celkem,49,53,4,2024,13
24_13_8_Suc_B10_2,Succisa_pratensis,deposition_celkem,45,53,8,2024,13
24_13_8_Suc_B10_3,Succisa_pratensis,deposition_celkem,46,54,8,2024,13
24_13_8_Suc_B11_1,Succisa_pratensis,deposition_celkem,25,27,2,2024,13
24_13_8_Suc_B11_2,Succisa_pratensis,deposition_celkem,26,29,3,2024,13
24_13_8_Suc_B11_3,Succisa_pratensis,deposition_celkem,34,39,5,2024,13
24_13_8_Suc_B12_1,Succisa_pratensis,deposition_celkem,6,11,5,2024,13
24_13_8_Suc_B12_2,Succisa_pratensis,deposition_celkem,0,0,0,2024,13
24_13_8_Suc_B12_3,Succisa_pratensis,deposition_celkem,2,2,0,2024,13
24_13_8_Suc_B13_1,Succisa_pratensis,deposition_celkem,45,96,51,2024,13
24_13_8_Suc_B13_2,Succisa_pratensis,deposition_celkem,23,59,36,2024,13
24_13_8_Suc_B13_3,Succisa_pratensis,deposition_celkem,19,47,28,2024,13
24_13_8_Suc_B14_1,Succisa_pratensis,deposition_celkem,0,0,0,2024,13
24_13_8_Suc_B14_2,Succisa_pratensis,deposition_celkem,0,0,0,2024,13
24_13_8_Suc_B14_3,Succisa_pratensis,deposition_celkem,5,7,2,2024,13
24_13_8_Suc_B15_1,Succisa_pratensis,deposition_celkem,7,7,0,2024,13
24_13_8_Suc_B15_2,Succisa_pratensis,deposition_celkem,2,2,0,2024,13
24_13_8_Suc_B15_3,Succisa_pratensis,deposition_celkem,0,0,0,2024,13
24_13_8_Suc_B16_1,Succisa_pratensis,deposition_celkem,42,58,16,2024,13
24_13_8_Suc_B16_2,Succisa_pratensis,deposition_celkem,39,68,29,2024,13
24_13_8_Suc_B16_3,Succisa_pratensis,deposition_celkem,36,71,35,2024,13
24_13_8_Suc_B17_1,Succisa_pratensis,deposition_celkem,35,35,0,2024,13
24_13_8_Suc_B17_2,Succisa_pratensis,deposition_celkem,39,39,0,2024,13
24_13_8_Suc_B17_3,Succisa_pratensis,deposition_celkem,46,49,3,2024,13
24_13_8_Suc_B18_1,Succisa_pratensis,deposition_celkem,48,61,13,2024,13
24_13_8_Suc_B18_2,Succisa_pratensis,deposition_celkem,17,18,1,2024,13
24_13_8_Suc_B18_3,Succisa_pratensis,deposition_celkem,33,37,4,2024,13
24_13_8_Suc_B19_1,Succisa_pratensis,deposition_celkem,22,44,22,2024,13
24_13_8_Suc_B19_2,Succisa_pratensis,deposition_celkem,38,42,4,2024,13
24_13_8_Suc_B19_3,Succisa_pratensis,deposition_celkem,NA,NA,NA,2024,13
24_13_8_Suc_B20_1,Succisa_pratensis,deposition_celkem,28,29,1,2024,13
24_13_8_Suc_B20_2,Succisa_pratensis,deposition_celkem,18,28,10,2024,13
24_13_8_Suc_B20_3,Succisa_pratensis,deposition_celkem,42,45,3,2024,13
24_13_8_Suc_B21_1,Succisa_pratensis,deposition_celkem,28,29,1,2024,13
24_13_8_Suc_B21_2,Succisa_pratensis,deposition_celkem,45,58,13,2024,13
24_13_8_Suc_B21_3,Succisa_pratensis,deposition_celkem,29,35,6,2024,13
24_13_8_Suc_B22_1,Succisa_pratensis,deposition_celkem,41,44,3,2024,13
24_13_8_Suc_B22_2,Succisa_pratensis,deposition_celkem,22,25,3,2024,13
24_13_8_Suc_B22_3,Succisa_pratensis,deposition_celkem,33,34,1,2024,13
24_13_8_Suc_B23_1,Succisa_pratensis,deposition_celkem,20,20,0,2024,13
24_13_8_Suc_B23_2,Succisa_pratensis,deposition_celkem,0,0,0,2024,13
24_13_8_Suc_B23_3,Succisa_pratensis,deposition_celkem,13,16,3,2024,13
24_13_8_Suc_B24_1,Succisa_pratensis,deposition_celkem,60,77,17,2024,13
24_13_8_Suc_B24_2,Succisa_pratensis,deposition_celkem,44,61,17,2024,13
24_13_8_Suc_B24_3,Succisa_pratensis,deposition_celkem,NA,NA,NA,2024,13
24_13_8_Suc_B25_1,Succisa_pratensis,deposition_celkem,41,44,3,2024,13
24_13_8_Suc_B25_2,Succisa_pratensis,deposition_celkem,21,21,0,2024,13
24_13_8_Suc_B25_3,Succisa_pratensis,deposition_celkem,39,42,3,2024,13
24_13_8_Suc_B26_1,Succisa_pratensis,deposition_celkem,41,42,1,2024,13
24_13_8_Suc_B26_2,Succisa_pratensis,deposition_celkem,35,36,1,2024,13
24_13_8_Suc_B26_3,Succisa_pratensis,deposition_celkem,42,45,3,2024,13
24_13_8_Suc_B27_1,Succisa_pratensis,deposition_celkem,32,35,3,2024,13
24_13_8_Suc_B27_2,Succisa_pratensis,deposition_celkem,45,45,0,2024,13
24_13_8_Suc_B27_3,Succisa_pratensis,deposition_celkem,45,45,0,2024,13
24_13_8_Suc_B28_1,Succisa_pratensis,deposition_celkem,2,2,0,2024,13
24_13_8_Suc_B28_2,Succisa_pratensis,deposition_celkem,61,71,10,2024,13
24_13_8_Suc_B28_3,Succisa_pratensis,deposition_celkem,52,52,0,2024,13
24_13_8_Suc_B29_1,Succisa_pratensis,deposition_celkem,11,12,1,2024,13
24_13_8_Suc_B29_2,Succisa_pratensis,deposition_celkem,0,0,0,2024,13
24_13_8_Suc_B29_3,Succisa_pratensis,deposition_celkem,5,6,1,2024,13
24_13_8_Suc_B30_1,Succisa_pratensis,deposition_celkem,0,0,0,2024,13
24_13_8_Suc_B30_2,Succisa_pratensis,deposition_celkem,0,0,0,2024,13
24_13_8_Suc_B30_3,Succisa_pratensis,deposition_celkem,0,0,0,2024,13
24_14_8_Suc_B1_1,Succisa_pratensis,deposition_celkem,16,36,20,2024,14
24_14_8_Suc_B1_2,Succisa_pratensis,deposition_celkem,45,56,11,2024,14
24_14_8_Suc_B1_3,Succisa_pratensis,deposition_celkem,17,37,20,2024,14
24_14_8_Suc_B2_1,Succisa_pratensis,deposition_celkem,21,33,12,2024,14
24_14_8_Suc_B2_2,Succisa_pratensis,deposition_celkem,NA,NA,NA,2024,14
24_14_8_Suc_B2_3,Succisa_pratensis,deposition_celkem,26,37,11,2024,14
24_14_8_Suc_B3_1,Succisa_pratensis,deposition_celkem,11,20,9,2024,14
24_14_8_Suc_B3_2,Succisa_pratensis,deposition_celkem,22,29,7,2024,14
24_14_8_Suc_B3_3,Succisa_pratensis,deposition_celkem,24,24,0,2024,14
24_14_8_Suc_B4_1,Succisa_pratensis,deposition_celkem,15,32,17,2024,14
24_14_8_Suc_B4_2,Succisa_pratensis,deposition_celkem,5,17,12,2024,14
24_14_8_Suc_B4_3,Succisa_pratensis,deposition_celkem,16,26,10,2024,14
24_14_8_Suc_B5_1,Succisa_pratensis,deposition_celkem,23,32,9,2024,14
24_14_8_Suc_B5_2,Succisa_pratensis,deposition_celkem,2,3,1,2024,14
24_14_8_Suc_B5_3,Succisa_pratensis,deposition_celkem,28,34,6,2024,14
24_14_8_Suc_B6_1,Succisa_pratensis,deposition_celkem,NA,NA,NA,2024,14
24_14_8_Suc_B6_2,Succisa_pratensis,deposition_celkem,0,11,11,2024,14
24_14_8_Suc_B6_3,Succisa_pratensis,deposition_celkem,1,5,4,2024,14
24_14_8_Suc_B7_1,Succisa_pratensis,deposition_celkem,24,27,3,2024,14
24_14_8_Suc_B7_2,Succisa_pratensis,deposition_celkem,29,34,5,2024,14
24_14_8_Suc_B7_3,Succisa_pratensis,deposition_celkem,19,29,10,2024,14
24_14_8_Suc_B8_1,Succisa_pratensis,deposition_celkem,44,50,6,2024,14
24_14_8_Suc_B8_2,Succisa_pratensis,deposition_celkem,2,3,1,2024,14
24_14_8_Suc_B8_3,Succisa_pratensis,deposition_celkem,3,3,0,2024,14
24_14_8_Suc_B9_1,Succisa_pratensis,deposition_celkem,36,38,2,2024,14
24_14_8_Suc_B9_2,Succisa_pratensis,deposition_celkem,32,36,4,2024,14
24_14_8_Suc_B9_3,Succisa_pratensis,deposition_celkem,50,50,0,2024,14
24_14_8_Suc_B10_1,Succisa_pratensis,deposition_celkem,23,27,4,2024,14
24_14_8_Suc_B10_2,Succisa_pratensis,deposition_celkem,47,52,5,2024,14
24_14_8_Suc_B10_3,Succisa_pratensis,deposition_celkem,52,65,13,2024,14
24_14_8_Suc_B11_1,Succisa_pratensis,deposition_celkem,38,40,2,2024,14
24_14_8_Suc_B11_2,Succisa_pratensis,deposition_celkem,55,58,3,2024,14
24_14_8_Suc_B11_3,Succisa_pratensis,deposition_celkem,40,47,7,2024,14
24_14_8_Suc_B12_1,Succisa_pratensis,deposition_celkem,43,47,4,2024,14
24_14_8_Suc_B12_2,Succisa_pratensis,deposition_celkem,57,64,7,2024,14
24_14_8_Suc_B12_3,Succisa_pratensis,deposition_celkem,54,56,2,2024,14
24_14_8_Suc_B13_1,Succisa_pratensis,deposition_celkem,42,50,8,2024,14
24_14_8_Suc_B13_2,Succisa_pratensis,deposition_celkem,35,37,2,2024,14
24_14_8_Suc_B13_3,Succisa_pratensis,deposition_celkem,37,39,2,2024,14
24_14_8_Suc_B14_1,Succisa_pratensis,deposition_celkem,27,31,4,2024,14
24_14_8_Suc_B14_2,Succisa_pratensis,deposition_celkem,NA,NA,NA,2024,14
24_14_8_Suc_B14_3,Succisa_pratensis,deposition_celkem,23,24,1,2024,14
24_14_8_Suc_B15_1,Succisa_pratensis,deposition_celkem,9,11,2,2024,14
24_14_8_Suc_B15_2,Succisa_pratensis,deposition_celkem,14,16,2,2024,14
24_14_8_Suc_B15_3,Succisa_pratensis,deposition_celkem,18,19,1,2024,14
24_14_8_Suc_B16_1,Succisa_pratensis,deposition_celkem,21,32,11,2024,14
24_14_8_Suc_B16_2,Succisa_pratensis,deposition_celkem,27,33,6,2024,14
24_14_8_Suc_B16_3,Succisa_pratensis,deposition_celkem,25,32,7,2024,14
24_14_8_Suc_B17_1,Succisa_pratensis,deposition_celkem,6,27,21,2024,14
24_14_8_Suc_B17_2,Succisa_pratensis,deposition_celkem,5,10,5,2024,14
24_14_8_Suc_B17_3,Succisa_pratensis,deposition_celkem,10,33,23,2024,14
24_14_8_Suc_B18_1,Succisa_pratensis,deposition_celkem,18,20,2,2024,14
24_14_8_Suc_B18_2,Succisa_pratensis,deposition_celkem,21,29,8,2024,14
24_14_8_Suc_B18_3,Succisa_pratensis,deposition_celkem,42,47,5,2024,14
24_14_8_Suc_B19_1,Succisa_pratensis,deposition_celkem,1,3,2,2024,14
24_14_8_Suc_B19_2,Succisa_pratensis,deposition_celkem,5,6,1,2024,14
24_14_8_Suc_B19_3,Succisa_pratensis,deposition_celkem,31,35,4,2024,14
24_14_8_Suc_B20_1,Succisa_pratensis,deposition_celkem,20,24,4,2024,14
24_14_8_Suc_B20_2,Succisa_pratensis,deposition_celkem,2,6,4,2024,14
24_14_8_Suc_B20_3,Succisa_pratensis,deposition_celkem,22,30,8,2024,14
24_14_8_Suc_B21_1,Succisa_pratensis,deposition_celkem,13,34,21,2024,14
24_14_8_Suc_B21_2,Succisa_pratensis,deposition_celkem,10,50,40,2024,14
24_14_8_Suc_B21_3,Succisa_pratensis,deposition_celkem,18,94,76,2024,14
24_14_8_Suc_B22_1,Succisa_pratensis,deposition_celkem,0,0,0,2024,14
24_14_8_Suc_B22_2,Succisa_pratensis,deposition_celkem,7,7,0,2024,14
24_14_8_Suc_B22_3,Succisa_pratensis,deposition_celkem,0,0,0,2024,14
24_14_8_Suc_B23_1,Succisa_pratensis,deposition_celkem,39,42,3,2024,14
24_14_8_Suc_B23_2,Succisa_pratensis,deposition_celkem,35,39,4,2024,14
24_14_8_Suc_B23_3,Succisa_pratensis,deposition_celkem,50,58,8,2024,14
24_14_8_Suc_B24_1,Succisa_pratensis,deposition_celkem,61,73,12,2024,14
24_14_8_Suc_B24_2,Succisa_pratensis,deposition_celkem,52,68,16,2024,14
24_14_8_Suc_B24_3,Succisa_pratensis,deposition_celkem,30,35,5,2024,14
24_14_8_Suc_B25_1,Succisa_pratensis,deposition_celkem,14,31,17,2024,14
24_14_8_Suc_B25_2,Succisa_pratensis,deposition_celkem,16,44,28,2024,14
24_14_8_Suc_B25_3,Succisa_pratensis,deposition_celkem,11,45,34,2024,14
24_14_8_Suc_B26_1,Succisa_pratensis,deposition_celkem,10,25,15,2024,14
24_14_8_Suc_B26_2,Succisa_pratensis,deposition_celkem,16,44,28,2024,14
24_14_8_Suc_B26_3,Succisa_pratensis,deposition_celkem,16,36,20,2024,14
24_14_8_Suc_B27_1,Succisa_pratensis,deposition_celkem,21,87,66,2024,14
24_14_8_Suc_B27_2,Succisa_pratensis,deposition_celkem,52,57,5,2024,14
24_14_8_Suc_B27_3,Succisa_pratensis,deposition_celkem,25,30,5,2024,14
24_14_8_Suc_B28_1,Succisa_pratensis,deposition_celkem,17,26,9,2024,14
24_14_8_Suc_B28_2,Succisa_pratensis,deposition_celkem,19,27,8,2024,14
24_14_8_Suc_B28_3,Succisa_pratensis,deposition_celkem,9,10,1,2024,14
24_14_8_Suc_B29_1,Succisa_pratensis,deposition_celkem,20,44,24,2024,14
24_14_8_Suc_B29_2,Succisa_pratensis,deposition_celkem,11,30,19,2024,14
24_14_8_Suc_B29_3,Succisa_pratensis,deposition_celkem,8,49,41,2024,14
24_14_8_Suc_B30_1,Succisa_pratensis,deposition_celkem,51,60,9,2024,14
24_14_8_Suc_B30_2,Succisa_pratensis,deposition_celkem,27,44,17,2024,14
24_14_8_Suc_B30_3,Succisa_pratensis,deposition_celkem,24,47,23,2024,14
24_15_8_Suc_B1_1,Succisa_pratensis,deposition_celkem,53,58,5,2024,15
24_15_8_Suc_B1_2,Succisa_pratensis,deposition_celkem,28,28,0,2024,15
24_15_8_Suc_B1_3,Succisa_pratensis,deposition_celkem,22,22,0,2024,15
24_15_8_Suc_B2_1,Succisa_pratensis,deposition_celkem,14,33,19,2024,15
24_15_8_Suc_B2_2,Succisa_pratensis,deposition_celkem,16,34,18,2024,15
24_15_8_Suc_B2_3,Succisa_pratensis,deposition_celkem,NA,NA,NA,2024,15
24_15_8_Suc_B3_1,Succisa_pratensis,deposition_celkem,2,3,1,2024,15
24_15_8_Suc_B3_2,Succisa_pratensis,deposition_celkem,2,6,4,2024,15
24_15_8_Suc_B3_3,Succisa_pratensis,deposition_celkem,15,15,0,2024,15
24_15_8_Suc_B4_1,Succisa_pratensis,deposition_celkem,44,59,15,2024,15
24_15_8_Suc_B4_2,Succisa_pratensis,deposition_celkem,77,92,15,2024,15
24_15_8_Suc_B4_3,Succisa_pratensis,deposition_celkem,50,63,13,2024,15
24_15_8_Suc_B5_1,Succisa_pratensis,deposition_celkem,30,34,4,2024,15
24_15_8_Suc_B5_2,Succisa_pratensis,deposition_celkem,31,34,3,2024,15
24_15_8_Suc_B5_3,Succisa_pratensis,deposition_celkem,34,34,0,2024,15
24_15_8_Suc_B6_1,Succisa_pratensis,deposition_celkem,39,47,8,2024,15
24_15_8_Suc_B6_2,Succisa_pratensis,deposition_celkem,38,39,1,2024,15
24_15_8_Suc_B6_3,Succisa_pratensis,deposition_celkem,18,20,2,2024,15
24_15_8_Suc_B7_1,Succisa_pratensis,deposition_celkem,23,46,23,2024,15
24_15_8_Suc_B7_2,Succisa_pratensis,deposition_celkem,38,62,24,2024,15
24_15_8_Suc_B7_3,Succisa_pratensis,deposition_celkem,21,43,22,2024,15
24_15_8_Suc_B8_1,Succisa_pratensis,deposition_celkem,8,9,1,2024,15
24_15_8_Suc_B8_2,Succisa_pratensis,deposition_celkem,27,31,4,2024,15
24_15_8_Suc_B8_3,Succisa_pratensis,deposition_celkem,1,8,7,2024,15
24_15_8_Suc_B9_1,Succisa_pratensis,deposition_celkem,16,23,7,2024,15
24_15_8_Suc_B9_2,Succisa_pratensis,deposition_celkem,18,25,7,2024,15
24_15_8_Suc_B9_3,Succisa_pratensis,deposition_celkem,16,21,5,2024,15
24_15_8_Suc_B10_1,Succisa_pratensis,deposition_celkem,31,53,22,2024,15
24_15_8_Suc_B10_2,Succisa_pratensis,deposition_celkem,25,26,1,2024,15
24_15_8_Suc_B10_3,Succisa_pratensis,deposition_celkem,42,46,4,2024,15
24_15_8_Suc_B11_1,Succisa_pratensis,deposition_celkem,9,12,3,2024,15
24_15_8_Suc_B11_2,Succisa_pratensis,deposition_celkem,25,29,4,2024,15
24_15_8_Suc_B11_3,Succisa_pratensis,deposition_celkem,3,4,1,2024,15
24_15_8_Suc_B12_1,Succisa_pratensis,deposition_celkem,42,51,9,2024,15
24_15_8_Suc_B12_2,Succisa_pratensis,deposition_celkem,35,40,5,2024,15
24_15_8_Suc_B12_3,Succisa_pratensis,deposition_celkem,46,51,5,2024,15
24_15_8_Suc_B13_1,Succisa_pratensis,deposition_celkem,7,11,4,2024,15
24_15_8_Suc_B13_2,Succisa_pratensis,deposition_celkem,4,8,4,2024,15
24_15_8_Suc_B13_3,Succisa_pratensis,deposition_celkem,1,14,13,2024,15
24_15_8_Suc_B14_1,Succisa_pratensis,deposition_celkem,45,69,24,2024,15
24_15_8_Suc_B14_2,Succisa_pratensis,deposition_celkem,48,81,33,2024,15
24_15_8_Suc_B14_3,Succisa_pratensis,deposition_celkem,21,34,13,2024,15
24_15_8_Suc_B15_1,Succisa_pratensis,deposition_celkem,28,32,4,2024,15
24_15_8_Suc_B15_2,Succisa_pratensis,deposition_celkem,49,52,3,2024,15
24_15_8_Suc_B15_3,Succisa_pratensis,deposition_celkem,62,65,3,2024,15
24_15_8_Suc_B16_1,Succisa_pratensis,deposition_celkem,15,27,12,2024,15
24_15_8_Suc_B16_2,Succisa_pratensis,deposition_celkem,15,17,2,2024,15
24_15_8_Suc_B16_3,Succisa_pratensis,deposition_celkem,31,31,0,2024,15
24_15_8_Suc_B17_1,Succisa_pratensis,deposition_celkem,24,28,4,2024,15
24_15_8_Suc_B17_2,Succisa_pratensis,deposition_celkem,27,35,8,2024,15
24_15_8_Suc_B17_3,Succisa_pratensis,deposition_celkem,17,20,3,2024,15
24_15_8_Suc_B18_1,Succisa_pratensis,deposition_celkem,14,52,38,2024,15
24_15_8_Suc_B18_2,Succisa_pratensis,deposition_celkem,11,53,42,2024,15
24_15_8_Suc_B18_3,Succisa_pratensis,deposition_celkem,24,43,19,2024,15
24_15_8_Suc_B19_1,Succisa_pratensis,deposition_celkem,0,0,0,2024,15
24_15_8_Suc_B19_2,Succisa_pratensis,deposition_celkem,19,22,3,2024,15
24_15_8_Suc_B19_3,Succisa_pratensis,deposition_celkem,11,16,5,2024,15
24_15_8_Suc_B20_1,Succisa_pratensis,deposition_celkem,NA,NA,NA,2024,15
24_15_8_Suc_B20_2,Succisa_pratensis,deposition_celkem,40,42,2,2024,15
24_15_8_Suc_B20_3,Succisa_pratensis,deposition_celkem,51,54,3,2024,15
24_15_8_Suc_B21_1,Succisa_pratensis,deposition_celkem,9,15,6,2024,15
24_15_8_Suc_B21_2,Succisa_pratensis,deposition_celkem,6,20,14,2024,15
24_15_8_Suc_B21_3,Succisa_pratensis,deposition_celkem,7,40,33,2024,15
24_15_8_Suc_B22_1,Succisa_pratensis,deposition_celkem,25,68,43,2024,15
24_15_8_Suc_B22_2,Succisa_pratensis,deposition_celkem,16,54,38,2024,15
24_15_8_Suc_B22_3,Succisa_pratensis,deposition_celkem,24,58,34,2024,15
24_15_8_Suc_B23_1,Succisa_pratensis,deposition_celkem,8,47,39,2024,15
24_15_8_Suc_B23_2,Succisa_pratensis,deposition_celkem,20,23,3,2024,15
24_15_8_Suc_B23_3,Succisa_pratensis,deposition_celkem,22,29,7,2024,15
24_15_8_Suc_B24_1,Succisa_pratensis,deposition_celkem,21,24,3,2024,15
24_15_8_Suc_B24_2,Succisa_pratensis,deposition_celkem,19,36,17,2024,15
24_15_8_Suc_B24_3,Succisa_pratensis,deposition_celkem,14,28,14,2024,15
24_15_8_Suc_B25_1,Succisa_pratensis,deposition_celkem,38,42,4,2024,15
24_15_8_Suc_B25_2,Succisa_pratensis,deposition_celkem,21,30,9,2024,15
24_15_8_Suc_B25_3,Succisa_pratensis,deposition_celkem,36,37,1,2024,15
24_15_8_Suc_B26_1,Succisa_pratensis,deposition_celkem,0,0,0,2024,15
24_15_8_Suc_B26_2,Succisa_pratensis,deposition_celkem,0,0,0,2024,15
24_15_8_Suc_B26_3,Succisa_pratensis,deposition_celkem,0,0,0,2024,15
24_15_8_Suc_B27_1,Succisa_pratensis,deposition_celkem,43,47,4,2024,15
24_15_8_Suc_B27_2,Succisa_pratensis,deposition_celkem,28,40,12,2024,15
24_15_8_Suc_B27_3,Succisa_pratensis,deposition_celkem,33,37,4,2024,15
24_15_8_Suc_B28_1,Succisa_pratensis,deposition_celkem,41,59,18,2024,15
24_15_8_Suc_B28_2,Succisa_pratensis,deposition_celkem,41,45,4,2024,15
24_15_8_Suc_B28_3,Succisa_pratensis,deposition_celkem,37,74,37,2024,15
24_15_8_Suc_B29_1,Succisa_pratensis,deposition_celkem,25,29,4,2024,15
24_15_8_Suc_B29_2,Succisa_pratensis,deposition_celkem,44,48,4,2024,15
24_15_8_Suc_B29_3,Succisa_pratensis,deposition_celkem,28,35,7,2024,15
24_15_8_Suc_B30_1,Succisa_pratensis,deposition_celkem,30,39,9,2024,15
24_15_8_Suc_B30_2,Succisa_pratensis,deposition_celkem,31,38,7,2024,15
24_15_8_Suc_B30_3,Succisa_pratensis,deposition_celkem,26,36,10,2024,15
24_16_8_Suc_B1_1,Succisa_pratensis,deposition_celkem,39,105,66,2024,16
24_16_8_Suc_B1_2,Succisa_pratensis,deposition_celkem,NA,NA,NA,2024,16
24_16_8_Suc_B1_3,Succisa_pratensis,deposition_celkem,NA,NA,NA,2024,16
24_16_8_Suc_B2_1,Succisa_pratensis,deposition_celkem,NA,NA,NA,2024,16
24_16_8_Suc_B2_2,Succisa_pratensis,deposition_celkem,NA,NA,NA,2024,16
24_16_8_Suc_B2_3,Succisa_pratensis,deposition_celkem,NA,NA,NA,2024,16
24_16_8_Suc_B3_1,Succisa_pratensis,deposition_celkem,NA,NA,NA,2024,16
24_16_8_Suc_B3_2,Succisa_pratensis,deposition_celkem,NA,NA,NA,2024,16
24_16_8_Suc_B3_3,Succisa_pratensis,deposition_celkem,NA,NA,NA,2024,16
24_16_8_Suc_B4_1,Succisa_pratensis,deposition_celkem,60,70,10,2024,16
24_16_8_Suc_B4_2,Succisa_pratensis,deposition_celkem,49,95,46,2024,16
24_16_8_Suc_B4_3,Succisa_pratensis,deposition_celkem,0,0,0,2024,16
24_16_8_Suc_B5_1,Succisa_pratensis,deposition_celkem,6,6,0,2024,16
24_16_8_Suc_B5_2,Succisa_pratensis,deposition_celkem,2,3,1,2024,16
24_16_8_Suc_B5_3,Succisa_pratensis,deposition_celkem,0,0,0,2024,16
24_16_8_Suc_B6_1,Succisa_pratensis,deposition_celkem,11,28,17,2024,16
24_16_8_Suc_B6_2,Succisa_pratensis,deposition_celkem,16,33,17,2024,16
24_16_8_Suc_B6_3,Succisa_pratensis,deposition_celkem,27,50,23,2024,16
24_16_8_Suc_B7_1,Succisa_pratensis,deposition_celkem,46,52,6,2024,16
24_16_8_Suc_B7_2,Succisa_pratensis,deposition_celkem,36,50,14,2024,16
24_16_8_Suc_B7_3,Succisa_pratensis,deposition_celkem,26,40,14,2024,16
24_16_8_Suc_B8_1,Succisa_pratensis,deposition_celkem,40,58,18,2024,16
24_16_8_Suc_B8_2,Succisa_pratensis,deposition_celkem,7,28,21,2024,16
24_16_8_Suc_B8_3,Succisa_pratensis,deposition_celkem,46,74,28,2024,16
24_16_8_Suc_B9_1,Succisa_pratensis,deposition_celkem,22,43,21,2024,16
24_16_8_Suc_B9_2,Succisa_pratensis,deposition_celkem,5,22,17,2024,16
24_16_8_Suc_B9_3,Succisa_pratensis,deposition_celkem,9,107,98,2024,16
24_16_8_Suc_B10_1,Succisa_pratensis,deposition_celkem,21,33,12,2024,16
24_16_8_Suc_B10_2,Succisa_pratensis,deposition_celkem,16,37,21,2024,16
24_16_8_Suc_B10_3,Succisa_pratensis,deposition_celkem,14,32,18,2024,16
24_16_8_Suc_B11_1,Succisa_pratensis,deposition_celkem,0,0,0,2024,16
24_16_8_Suc_B11_2,Succisa_pratensis,deposition_celkem,14,20,6,2024,16
24_16_8_Suc_B11_3,Succisa_pratensis,deposition_celkem,1,6,5,2024,16
24_16_8_Suc_B12_1,Succisa_pratensis,deposition_celkem,20,22,2,2024,16
24_16_8_Suc_B12_2,Succisa_pratensis,deposition_celkem,0,0,0,2024,16
24_16_8_Suc_B12_3,Succisa_pratensis,deposition_celkem,0,0,0,2024,16
24_16_8_Suc_B13_1,Succisa_pratensis,deposition_celkem,24,25,1,2024,16
24_16_8_Suc_B13_2,Succisa_pratensis,deposition_celkem,38,39,1,2024,16
24_16_8_Suc_B13_3,Succisa_pratensis,deposition_celkem,39,45,6,2024,16
24_16_8_Suc_B14_1,Succisa_pratensis,deposition_celkem,40,40,0,2024,16
24_16_8_Suc_B14_2,Succisa_pratensis,deposition_celkem,12,15,3,2024,16
24_16_8_Suc_B14_3,Succisa_pratensis,deposition_celkem,35,37,2,2024,16
24_16_8_Suc_B15_1,Succisa_pratensis,deposition_celkem,25,46,21,2024,16
24_16_8_Suc_B15_2,Succisa_pratensis,deposition_celkem,29,45,16,2024,16
24_16_8_Suc_B15_3,Succisa_pratensis,deposition_celkem,35,47,12,2024,16
24_16_8_Suc_B16_1,Succisa_pratensis,deposition_celkem,0,0,0,2024,16
24_16_8_Suc_B16_2,Succisa_pratensis,deposition_celkem,0,0,0,2024,16
24_16_8_Suc_B16_3,Succisa_pratensis,deposition_celkem,0,0,0,2024,16
24_16_8_Suc_B17_1,Succisa_pratensis,deposition_celkem,33,44,11,2024,16
24_16_8_Suc_B17_2,Succisa_pratensis,deposition_celkem,30,49,19,2024,16
24_16_8_Suc_B17_3,Succisa_pratensis,deposition_celkem,15,43,28,2024,16
24_16_8_Suc_B18_1,Succisa_pratensis,deposition_celkem,31,42,11,2024,16
24_16_8_Suc_B18_2,Succisa_pratensis,deposition_celkem,34,38,4,2024,16
24_16_8_Suc_B18_3,Succisa_pratensis,deposition_celkem,34,40,6,2024,16
24_16_8_Suc_B19_1,Succisa_pratensis,deposition_celkem,30,33,3,2024,16
24_16_8_Suc_B19_2,Succisa_pratensis,deposition_celkem,40,78,38,2024,16
24_16_8_Suc_B19_3,Succisa_pratensis,deposition_celkem,34,41,7,2024,16
24_16_8_Suc_B20_1,Succisa_pratensis,deposition_celkem,1,25,24,2024,16
24_16_8_Suc_B20_2,Succisa_pratensis,deposition_celkem,4,6,2,2024,16
24_16_8_Suc_B20_3,Succisa_pratensis,deposition_celkem,0,0,0,2024,16
24_16_8_Suc_B21_1,Succisa_pratensis,deposition_celkem,48,48,0,2024,16
24_16_8_Suc_B21_2,Succisa_pratensis,deposition_celkem,48,48,0,2024,16
24_16_8_Suc_B21_3,Succisa_pratensis,deposition_celkem,34,34,0,2024,16
24_16_8_Suc_B22_1,Succisa_pratensis,deposition_celkem,1,8,7,2024,16
24_16_8_Suc_B22_2,Succisa_pratensis,deposition_celkem,15,33,18,2024,16
24_16_8_Suc_B22_3,Succisa_pratensis,deposition_celkem,20,33,13,2024,16
24_16_8_Suc_B23_1,Succisa_pratensis,deposition_celkem,18,20,2,2024,16
24_16_8_Suc_B23_2,Succisa_pratensis,deposition_celkem,56,81,25,2024,16
24_16_8_Suc_B23_3,Succisa_pratensis,deposition_celkem,57,73,16,2024,16
24_16_8_Suc_B24_1,Succisa_pratensis,deposition_celkem,12,41,29,2024,16
24_16_8_Suc_B24_2,Succisa_pratensis,deposition_celkem,15,32,17,2024,16
24_16_8_Suc_B24_3,Succisa_pratensis,deposition_celkem,21,27,6,2024,16
24_16_8_Suc_B25_1,Succisa_pratensis,deposition_celkem,33,39,6,2024,16
24_16_8_Suc_B25_2,Succisa_pratensis,deposition_celkem,76,76,0,2024,16
24_16_8_Suc_B25_3,Succisa_pratensis,deposition_celkem,44,44,0,2024,16
24_16_8_Suc_B26_1,Succisa_pratensis,deposition_celkem,43,51,8,2024,16
24_16_8_Suc_B26_2,Succisa_pratensis,deposition_celkem,22,42,20,2024,16
24_16_8_Suc_B26_3,Succisa_pratensis,deposition_celkem,57,78,21,2024,16
24_16_8_Suc_B27_1,Succisa_pratensis,deposition_celkem,16,26,10,2024,16
24_16_8_Suc_B27_2,Succisa_pratensis,deposition_celkem,24,28,4,2024,16
24_16_8_Suc_B27_3,Succisa_pratensis,deposition_celkem,24,24,0,2024,16
24_16_8_Suc_B28_1,Succisa_pratensis,deposition_celkem,39,43,4,2024,16
24_16_8_Suc_B28_2,Succisa_pratensis,deposition_celkem,31,34,3,2024,16
24_16_8_Suc_B28_3,Succisa_pratensis,deposition_celkem,28,31,3,2024,16
24_16_8_Suc_B29_1,Succisa_pratensis,deposition_celkem,36,49,13,2024,16
24_16_8_Suc_B29_2,Succisa_pratensis,deposition_celkem,50,71,21,2024,16
24_16_8_Suc_B29_3,Succisa_pratensis,deposition_celkem,36,90,54,2024,16
24_16_8_Suc_B30_1,Succisa_pratensis,deposition_celkem,1,1,0,2024,16
24_16_8_Suc_B30_2,Succisa_pratensis,deposition_celkem,93,97,4,2024,16
24_16_8_Suc_B30_3,Succisa_pratensis,deposition_celkem,22,23,1,2024,16
